NO /home/mtn/Desktop/cub3d1/image/barrel.png
WE /home/mtn/Desktop/cub3d1/image/bluestone.png
EA /home/mtn/Desktop/cub3d1/image/eagle.png
SO /home/mtn/Desktop/cub3d1/image/wood.png

C 10,30,150
F 150,50,250

111111111111111111111111
111110001010100010000001
100000000000000000000001
100000000000000000000001
100100100100100100000001
110100010100010001000001
111010010000010010000011
110010000000010010000001
110000000E00000000000001
100000000000000000000001
111111111111111111111111