NO /home/mtn/Desktop/cub3d1/image/barrel.png
WE /home/mtn/Desktop/cub3d1/image/bluestone.png
EA /home/mtn/Desktop/cub3d1/image/eagle.png
SO /home/mtn/Desktop/cub3d1/image/wood.png

C 10,30,150
F 150,50,250

111111111111111111111111
101010001010100010000001
100000000000000000000001
100000000000000000000001
100100100100100100000001
110100010100010001000001
110010010000010010000001
110010000000010010000001
100000000000000000000001
100000000000000000000001
100000000000000000000001
100000001000000000000001
100000010100000000000001
100000000000000000000001
110011111000000000000001
110010000000000000000001
110010000000000000000001
110010000000010010000001
110010000000010010000001
110010000000010010000001
110010000000010010000001
110010000000010010000001
100000000000000000000001
100000000000000000000001
100000000000000000000001
100000000000000000000001
1000000000000000000000W1
111111111111111111111111